datetime,device_cpu_rate%,user%,system%,idle%,package,pid,pid_cpu%
2024-06-06 18-28-20,496,196,300,300,com.yangcong345.android.phone,6942,28.5
2024-06-06 18-28-25,410,224,186,376,com.yangcong345.android.phone,6942,141
2024-06-06 18-28-30,435,214,221,364,com.yangcong345.android.phone,6942,164
2024-06-06 18-28-35,467,180,287,327,com.yangcong345.android.phone,6942,246
2024-06-06 18-28-40,334,182,152,461,com.yangcong345.android.phone,6942,184
2024-06-06 18-28-45,475,204,271,307,com.yangcong345.android.phone,6942,142
2024-06-06 18-28-50,336,150,186,464,com.yangcong345.android.phone,6942,142
2024-06-06 18-28-55,462,210,252,338,com.yangcong345.android.phone,6942,182
2024-06-06 18-29-00,460,193,267,337,com.yangcong345.android.phone,6942,243
2024-06-06 18-29-05,487,250,237,313,com.yangcong345.android.phone,6942,180
2024-06-06 18-29-10,493,306,187,303,com.yangcong345.android.phone,6942,161
2024-06-06 18-29-15,610,293,317,187,com.yangcong345.android.phone,6942,173
2024-06-06 18-29-20,246,107,139,554,com.yangcong345.android.phone,6942,100
2024-06-06 18-29-25,293,129,164,500,com.yangcong345.android.phone,6942,100
2024-06-06 18-29-30,472,238,234,266,com.yangcong345.android.phone,6942,106
2024-06-06 18-29-35,733,363,370,3,com.yangcong345.android.phone,6942,183
2024-06-06 18-29-40,328,139,189,468,com.yangcong345.android.phone,6942,107
2024-06-06 18-29-45,371,164,207,421,com.yangcong345.android.phone,6942,107
2024-06-06 18-29-50,572,338,234,144,com.yangcong345.android.phone,6942,87.5
2024-06-06 18-29-55,336,132,204,461,com.yangcong345.android.phone,6942,103
2024-06-06 18-30-00,528,297,231,151,com.yangcong345.android.phone,6942,120
2024-06-06 18-30-05,730,413,317,27,com.yangcong345.android.phone,6942,153
2024-06-06 18-30-10,674,384,290,81,com.yangcong345.android.phone,6942,161
2024-06-06 18-30-15,474,245,229,323,com.yangcong345.android.phone,6942,116
2024-06-06 18-30-20,271,121,150,521,com.yangcong345.android.phone,6942,100
2024-06-06 18-30-25,500,217,283,297,com.yangcong345.android.phone,6942,150
2024-06-06 18-30-30,297,114,183,500,com.yangcong345.android.phone,6942,113
2024-06-06 18-30-35,334,124,210,466,com.yangcong345.android.phone,6942,106
2024-06-06 18-30-40,282,121,161,518,com.yangcong345.android.phone,6942,110
2024-06-06 18-30-45,310,124,186,490,com.yangcong345.android.phone,6942,103
2024-06-06 18-30-50,361,154,207,439,com.yangcong345.android.phone,6942,114
2024-06-06 18-30-55,445,179,266,355,com.yangcong345.android.phone,6942,103
2024-06-06 18-31-00,425,167,258,376,com.yangcong345.android.phone,6942,224
2024-06-06 18-31-05,469,203,266,331,com.yangcong345.android.phone,6942,165
2024-06-06 18-31-10,514,231,283,283,com.yangcong345.android.phone,6942,206
2024-06-06 18-31-15,346,146,200,454,com.yangcong345.android.phone,6942,121
2024-06-06 18-31-20,648,369,279,117,com.yangcong345.android.phone,6942,148
2024-06-06 18-31-25,526,263,263,270,com.yangcong345.android.phone,6942,100
2024-06-06 18-31-30,293,125,168,507,com.yangcong345.android.phone,6942,96.4
2024-06-06 18-31-35,320,137,183,470,com.yangcong345.android.phone,6942,103
2024-06-06 18-31-40,443,220,223,320,com.yangcong345.android.phone,6942,123
2024-06-06 18-31-45,566,290,276,183,com.yangcong345.android.phone,6942,117
2024-06-06 18-31-50,433,200,233,367,com.yangcong345.android.phone,6942,166
2024-06-06 18-31-55,314,145,169,483,com.yangcong345.android.phone,6942,120
2024-06-06 18-32-00,454,229,225,343,com.yangcong345.android.phone,6942,210
2024-06-06 18-32-05,320,193,127,473,com.yangcong345.android.phone,6942,146
2024-06-06 18-32-10,564,306,258,122,com.yangcong345.android.phone,6942,133
2024-06-06 18-32-15,664,377,287,7,com.yangcong345.android.phone,6942,126
2024-06-06 18-32-20,317,134,183,476,com.yangcong345.android.phone,6942,127
2024-06-06 18-32-25,519,258,261,277,com.yangcong345.android.phone,6942,264
2024-06-06 18-32-30,347,161,186,454,com.yangcong345.android.phone,6942,150
2024-06-06 18-32-35,445,221,224,355,com.yangcong345.android.phone,6942,168
2024-06-06 18-32-40,450,220,230,350,com.yangcong345.android.phone,6942,190
2024-06-06 18-32-45,494,247,247,303,com.yangcong345.android.phone,6942,186
2024-06-06 18-32-50,364,175,189,432,com.yangcong345.android.phone,6942,153
2024-06-06 18-32-55,372,217,155,417,com.yangcong345.android.phone,6942,127
2024-06-06 18-33-00,358,179,179,429,com.yangcong345.android.phone,6942,153
2024-06-06 18-33-05,473,252,221,328,com.yangcong345.android.phone,6942,162
2024-06-06 18-33-10,350,168,182,446,com.yangcong345.android.phone,6942,125
2024-06-06 18-33-15,318,168,150,482,com.yangcong345.android.phone,6942,139
2024-06-06 18-33-20,338,159,179,459,com.yangcong345.android.phone,6942,141
2024-06-06 18-33-25,404,190,214,397,com.yangcong345.android.phone,6942,127
2024-06-06 18-33-30,417,200,217,380,com.yangcong345.android.phone,6942,193
2024-06-06 18-33-35,393,200,193,396,com.yangcong345.android.phone,6942,203
2024-06-06 18-33-40,353,157,196,443,com.yangcong345.android.phone,6942,150
2024-06-06 18-33-45,507,224,283,286,com.yangcong345.android.phone,6942,151
2024-06-06 18-33-50,460,227,233,337,com.yangcong345.android.phone,6942,196
2024-06-06 18-33-55,296,146,150,504,com.yangcong345.android.phone,6942,132
2024-06-06 18-34-00,603,303,300,138,com.yangcong345.android.phone,6942,193
2024-06-06 18-34-05,430,239,191,367,com.yangcong345.android.phone,6942,184
2024-06-06 18-34-10,613,353,260,87,com.yangcong345.android.phone,6942,123
2024-06-06 18-34-15,314,138,176,483,com.yangcong345.android.phone,6942,93.1
2024-06-06 18-34-20,648,338,310,45,com.yangcong345.android.phone,6942,96.5
2024-06-06 18-34-25,267,121,146,529,com.yangcong345.android.phone,6942,110
2024-06-06 18-34-30,373,193,180,423,com.yangcong345.android.phone,6942,140
2024-06-06 18-34-35,603,343,260,147,com.yangcong345.android.phone,6942,150
2024-06-06 18-34-40,453,223,230,347,com.yangcong345.android.phone,6942,190
2024-06-06 18-34-45,318,143,175,482,com.yangcong345.android.phone,6942,125
2024-06-06 18-34-50,275,118,157,521,com.yangcong345.android.phone,6942,114
2024-06-06 18-34-55,379,125,254,421,com.yangcong345.android.phone,6942,203
2024-06-06 18-35-00,415,161,254,386,com.yangcong345.android.phone,6942,228
2024-06-06 18-35-05,379,169,210,421,com.yangcong345.android.phone,6942,113
2024-06-06 18-35-10,304,136,168,496,com.yangcong345.android.phone,6942,114
2024-06-06 18-35-15,318,175,143,479,com.yangcong345.android.phone,6942,121
2024-06-06 18-35-20,279,125,154,518,com.yangcong345.android.phone,6942,121
2024-06-06 18-35-25,330,145,185,464,com.yangcong345.android.phone,6942,169
2024-06-06 18-35-30,336,143,193,461,com.yangcong345.android.phone,6942,132
2024-06-06 18-35-35,369,186,183,428,com.yangcong345.android.phone,6942,127
2024-06-06 18-35-40,378,147,231,416,com.yangcong345.android.phone,6942,128
2024-06-06 18-35-45,544,237,307,253,com.yangcong345.android.phone,6942,170
2024-06-06 18-35-50,390,193,197,410,com.yangcong345.android.phone,6942,148
2024-06-06 18-35-56,488,218,270,309,com.yangcong345.android.phone,6942,151
2024-06-06 18-36-00,447,168,279,346,com.yangcong345.android.phone,6942,196
2024-06-06 18-36-05,527,267,260,217,com.yangcong345.android.phone,6942,123
2024-06-06 18-36-10,414,200,214,382,com.yangcong345.android.phone,6942,185
2024-06-06 18-36-15,393,139,254,407,com.yangcong345.android.phone,6942,96.4
2024-06-06 18-36-20,250,96,154,550,com.yangcong345.android.phone,6942,92.8
2024-06-06 18-36-25,393,175,218,407,com.yangcong345.android.phone,6942,153
2024-06-06 18-36-30,285,121,164,511,com.yangcong345.android.phone,6942,135
2024-06-06 18-36-35,342,148,194,458,com.yangcong345.android.phone,6942,116
2024-06-06 18-36-40,672,369,303,28,com.yangcong345.android.phone,6942,113
2024-06-06 18-36-46,758,455,303,71,com.yangcong345.android.phone,6942,109
2024-06-06 18-36-51,447,247,200,288,com.yangcong345.android.phone,6942,121
2024-06-06 18-36-56,513,253,260,287,com.yangcong345.android.phone,6942,160
2024-06-06 18-37-00,332,157,175,461,com.yangcong345.android.phone,6942,139
2024-06-06 18-37-06,380,163,217,420,com.yangcong345.android.phone,6942,146
2024-06-06 18-37-10,315,129,186,454,com.yangcong345.android.phone,6942,107
2024-06-06 18-37-15,276,152,124,521,com.yangcong345.android.phone,6942,120
2024-06-06 18-37-21,406,161,245,394,com.yangcong345.android.phone,6942,219
2024-06-06 18-37-25,293,121,172,497,com.yangcong345.android.phone,6942,155
2024-06-06 18-37-30,607,318,289,118,com.yangcong345.android.phone,6942,135
2024-06-06 18-37-36,593,303,290,203,com.yangcong345.android.phone,6942,182
2024-06-06 18-37-41,389,157,232,396,com.yangcong345.android.phone,6942,89.2
2024-06-06 18-37-46,651,390,261,61,com.yangcong345.android.phone,6942,135
2024-06-06 18-37-50,636,357,279,79,com.yangcong345.android.phone,6942,100
2024-06-06 18-37-55,286,129,157,511,com.yangcong345.android.phone,6942,128
2024-06-06 18-38-00,293,111,182,500,com.yangcong345.android.phone,6942,132
2024-06-06 18-38-06,618,354,264,125,com.yangcong345.android.phone,6942,125
2024-06-06 18-38-10,322,154,168,471,com.yangcong345.android.phone,6942,117
2024-06-06 18-38-16,332,161,171,468,com.yangcong345.android.phone,6942,146
2024-06-06 18-38-21,368,164,204,429,com.yangcong345.android.phone,6942,135
2024-06-06 18-38-26,535,269,266,266,com.yangcong345.android.phone,6942,227
2024-06-06 18-38-31,304,125,179,493,com.yangcong345.android.phone,6942,160
2024-06-06 18-38-36,314,139,175,479,com.yangcong345.android.phone,6942,192
2024-06-06 18-38-41,261,136,125,536,com.yangcong345.android.phone,6942,128
2024-06-06 18-38-46,237,137,100,557,com.yangcong345.android.phone,6942,126
2024-06-06 18-38-51,286,136,150,514,com.yangcong345.android.phone,6942,125
2024-06-06 18-38-56,642,359,283,7,com.yangcong345.android.phone,6942,113
2024-06-06 18-39-01,243,104,139,539,com.yangcong345.android.phone,6942,107
2024-06-06 18-39-06,250,107,143,550,com.yangcong345.android.phone,6942,103
2024-06-06 18-39-11,658,390,268,42,com.yangcong345.android.phone,6942,116
2024-06-06 18-39-16,472,236,236,329,com.yangcong345.android.phone,6942,128
2024-06-06 18-39-21,450,217,233,350,com.yangcong345.android.phone,6942,176
2024-06-06 18-39-26,336,152,184,458,com.yangcong345.android.phone,6942,200
2024-06-06 18-39-31,333,144,189,459,com.yangcong345.android.phone,6942,129
2024-06-06 18-39-36,261,129,132,539,com.yangcong345.android.phone,6942,135
2024-06-06 18-39-41,497,232,265,287,com.yangcong345.android.phone,6942,216
